1111111
0000001
1111101
1000101
1011101
1000000
1111111